%%%%%%%%%%%%%%%%%%%%%%%%%%%%%%
%                           P%
% %%%%%%%%%%%%%%%%%%%%%%% %%%%
% %%   %   % %%%% %%%%%%%%% %%
% %% % % %               %%%%%
% %% % % %%%%%%%% %%        %%
% %% %   %%       %% %%%%%% %%
%    %%%%%% %%%%%%%      %%%%%
%%%%%%      %       %%%%%%%%%%
%      %%%%%% %%%%% %       %%
% %%%%%%      %       %%%% %%%
%.       %%%%    %%%%%%%    %%
%%%%%%%%%%%%%%%%%%%%%%%%%%%%%%
